100
100
0011010000101101111001010011110001011010100010110111010101010111101011000100010101110110001101101100
0000000111100010011110000101110011110001110011011110101100110101011110011101100110100001111111001000
0111100011111011101000100111101110110110011001100101101001001110010010001110010111111110011100101010
0001110000001101001110010101111100110011110101101111001101011011001010000111001010001000011011001010
0010101101111000101011001000001011011110011010000000110111001000110010111011100111001001000101011111
0000111000100011110111001011011011101000100111110001001110110011101000110000000101110011111111111011
1100100011100111000101110010111110001001101010001001110011010110100000010110011010111010001110101101
0011000011101011000011101011000111101110001010110011110101110101001001010010101100111011001001101000
0111000001101010110111010110111001001000000000100110001001001100101101001011000000101101011001111011
1101100101111110100001010001101110000100110001101111101100000101011110011011100100101001100110100000
1111101100111111001001101011010001010110100011011111111001100001101010110100000001000011110101001110
0101100111010001001001111001011101010101000101011101100100001010010100101000001010111111110010111001
1101110010001100100111101000100011101101001100110000000100100000101111100110001011101001001010111010
1001111100010100100110110011010110011011010110101110000101001010111111110000001010001010111001011010
0001011011000011111000011111100011000101110011011111101001011001011010111100000010111011110110011010
1101111001011000100101111100001000111111100011111101101100011110000010010101000000000101100011001101
0000010000110001101011010100110001111000111011110111000110111101000111000001111100011101001101111111
1100111011100100111111111111010000110110010000110000110101000011000011011001011010010101000011000111
0000011110101101000101000000000011011000010000011100010101011110001000111010101001001101010100001110
0101001101101000000100101000110110000111001101011000010111000100101010111000111001101110111011101100
0011110100100011101011011101111001011100000011111100101011010010011101010100010010011100000111100100
1111111010010000000110110110010101110100111100011111001011101000011010010001111001001010101010000110
1100001010010010000100001101110011100100000110001111100100100001011111111010110110010111011011010000
1110000001011110011001110000111111010011111110011000101110011011000000000111101000100000001110010100
1110010101110011111110001000101110111011000110101101101010011011010000100010101111100100001100101011
1000001010100101110101000101000110110101100111110011111001001001111111010010001001000101000011001000
0011101100001100010100101110101110101101001001000011111011011000011101010111100010010001011100011010
1010100010101111101100100000101110010011100001001110100100001110010101000001100110011011111001011010
1111001100011100011011010011000101111101100010111101110011010010111000010000101001001100001111111000
0011110101001101100101100001100000011001011100111010111110010001111010101011001010100010110101011001
0000100000110011001101100011011111110100111111001001100110101011101011110101000110101000111101100100
1111101001000000110011110101001010110011000001000100010111100101011011111100000010100101000000110001
0010000111111111111001100000011100001011110011110010000001011010101010010001100001001110111111110010
0101110010111111001000111110110110101001100111110101100001000001100100011110110100100010100110000011
1010101111110000000101111011001001101101000110001001000100110110110101101000110101010100100110110010
0111001000001110110000101110010001110100010101000011110101010001100111011101101101110101000001100110
0011110100101101011000011100101011011100111000100101101010111101101001101001111100010001000000111000
0111010101000010000101110010111010000001101101001100110001011110111110011111001101001000100100101110
1111111101111011111100101100000011001101100100011111101101111010001101111001010011000010011001001011
0111011001001100000111000101010100000000001010011100101110010000110111000001001001011111010000100001
0111110000101000111000110001001110101010011110011001010100000001101011101000001101110011111100000001
0110110110110101011001100111001100100110000110011100100110110100101111110000100100101110111110111100
0111110010000111101110011110111111100101110101001000100001100000010111101110001000001010100100110000
1110010110011100010110001100000101101100100100101111011011001001110100110011100000101101000111000100
0001001010111001000100111111100100101001000101111001101111101111101100000110100111011100001010000100
0001011100001000011100000111101011100100000001000110011001101110001110000000000111000111100001100010
0000000010101011101110111101011000011101001001001011011111100111011001110011011011000111111100000011
0010111111101011010111011011010001101011011110010111011110001100100111011110000111000111110101011100
0110110110011110000010010011100001010110100101001001111101110001100111101011010110111010000000001000
0001001010001110101110110100110010110001110010110010100110110111101100100101010011111110110000101011
0111000011001001011101100011100000001100010110000111110010100111101101000110101101010010001110110111
1010100111011100010100010010111110101101110111110001000001110111010100010000001100101000101110001100
0111011110011111010111100111100000100110011010101111001000011101000000010101111011011110000010111000
0100000101110101010010101011011011001001110001000011010001110111111011011100010011001100100111010011
1000111101101001001100100000000100101101100011000011100011111000010101010110000101100111101100101001
0011100100001011111100000100000010011011001111111101100100111110101001001000010101110001100011001000
1101010110101011110101111111100010010000001010000110010011101101100100010111110001010110101101100110
1001001101010000110001111001101000010000010010101011000111000011111010111001110100010000011100011101
0111001000101111110100111001010110010110011011100010111101011011011011111101111101001010010100010000
0010001111011100100100001110000011101111100010001010100100101000010100011100100000010110000001101100
0101000110011001010101000011100011010111111111111001111000100111100110111011010010001001101101101111
1110110010011111000110110001000100110111010011010011001010000101011111110001101100000111101000111101
0010100110100101100101000110100111000001101011011101001011001100101000001000101100110101001001100010
1101111101001001010010010111100110011000010100111101001010000001100000101001101110010011110100000101
0000000100010011111011001011001011000101011100101101011000010011000011011011110010001010100010010110
1001001011000110110001011000110110100010011111000111111100000000000100101100111001111001011001101010
0100011101100000001111000100000100100011100010001100101011000010000101100101001001100111100111001001
1010010111001000100111110110000100011001010001111000011011001111000111101101000000111100001111110111
1010011110011101111001001010111111100111001111010000011010101101010001100010111011011010010011010101
0011000110101110011110000100100111001011010001011000101111010010000000011101111000100101110011101111
0011010010011011011000001010101111101000110000110110100101010111000000101011011000110011010110101111
0000101100100101000111101110001101001010111001101111111111100100110011001110100011011011100010110000
0001001101110101011100001000101111111010111000010111101100011001000001011110101001001011110000110000
1101100001110100010101010110101001100100110000001110100010000101100110111101000001101111010111110101
1111110010010000010000011101111110000001100110101010100110101011010001100011011000111001010010011110
1010010011010001111100001001000110100011100011000100111001110111110011011010011000110101000011001100
1100001100111100010111001001100111001000101101101110110010111010101101011111001101111101011011111110
1010011010110100100101110110101100000101001010000001100011111000010001001000110011001110001110001000
0000111110100001111000110111001101110010110111000000010011111100011000010001011001101001011101100110
1011110011000011100010110010011101011011111001100001100010011100110000000100101010101001100010011000
1110111011010010101000000011000111000001011111110111001111010111000010011010111111111101010100010111
0000000100101110110100111101010110001111111011011101011001101100001110011000000111011000010110101100
1110111100001111110110001011100001000011100001011101111010101001001101111111011011111001010010111001
0010100110111101110100100111000011001001011010001001001100000010011011001000100111000110000111010010
0010010111100001000111100010100010101001111000100011110010000011111110001000100111000110110110011100
1101110100010110111011011010111001001101011011111101100010011000101110010111010110101011100111101100
1100011101011111001100001110010100100011011001010110101110111101010000111101000101000111101011011100
1100001110111110111110011011001010011111000110110100001101111011011110100010101010010010010101001011
1011111000010001111010111101100100100111000000011010100110101001011100101011010110100101011010100100
0000101111010010111101010110101000001110010111100101000001100011010110010010000001010111000111000000
0100101000101011011100001111111101110011110000100001010110100101000001000100010110000000001110011011
0010111000110000110111011101010110110110100101010100010010101101010000110100000000011111001011010011
1000001001100001111100110101011011101011011001010110110111101001110011101001110111100000111101111110
1011110110110110000010110110110111011001000100010011001110110110101111000101000111101100000110010100
1010001011001001111011001111001000011110000101011111100101000100001011000011010100011101011001001100
0000100100111010101000010011010010000101001101000100000010001001001010100011001111111110101100110001
1100100111101110001111010010000110110111111011001111010111101111101111110000110001111111010011011010
0111111000100010000101000010011111001100010010001101101100101001010000111011001001101101011000110101
0110010101100111100110110001001111101010111101101001010000011100110001001010101101100100011010010111
1101000001100110110111010010001110101111001011001001011100110010111110100001011110110001100110100000
