100
100
0001101011011000001011100010001101011111101010011110000101011110000110111001110000101011010011000010
0110101111101010111111101100010111000100011111101011001101111010001001110100001010001101101100000100
0011110111000110000010001110111111110000001101000110100001001100010100111010010011111011011011010110
0111011110000101111111010100100011101000010100101011111111001100010010011100010001010001111011110010
1001001111110010100101100100011001101111101101011010001100110000100110110111000111011010111111000110
1110101010011011001000101110000010010110111100010001110100010001110000011111010111001011001100101110
1110110000001110001110011110101000100000101111100111010111101101111000000001101111000110100010000010
1010111010101101100111111111010100010001100110000001011011011000000010001110100101100011001101100001
0110101011010011011110000001110111100001001001110111010001010101010111110010000010011011100011000110
0100111110010100000111010010010000011101011101100010001101111010010111010001111011100011101111001111
0110001010000000101000011011111111001110101001111000100000111001010000000101011001101011100011100101
0010001011101001111100000010001000100111111011101101010011011111011110010000001111000110001011001011
1110111111110110011110111000100110100011100000101110111111001111110011011001100011010111101010000010
1100100110100101000110010101001000111100100111111101111000100001000000110010010101010000100000000001
0100110010110011000100110101000000011001111111000000000000100011000110000000110110100100110110111000
0011010111111101111010001010010001000111110111001101010101001101010011101000010001110100000100001000
0001001101111110001101100010110010000011010001011000010001100110100000010110001000110101110001011001
1011110010110000001100111101101100101111011111111001001101000110100101111101111010011000110000101101
1110111100111000100000110010000011000000011000101000111000110110100011100001011001011100010001101110
0000110000111101101100111000101100111110010010101110101111001001110110110000001111101010110100001111
1000001101100101101110010110011101101110011101101100100010010100011111011010011100001100111101010110
0001011001010000110110100010010110101100010000010001010011100101101101010111010100111100111001011000
0110101010101110010110110010110010001000010001101100100001011010011100110111111001011000101000101110
0110101010111011110010001111001111100110101111101011110001010011000010111100101111011110010101001000
0111001100101111000101110101010000101100010110101011100101010110101110001001110011101111111000111100
1101100011000110100001100000001011100110000100100000110101001010100011010010011101111111011100101111
0010101001101010110011110111011011000100001111111000000011001000110000010111001011101001011010000101
1011111001011000000101010111110111111001011111011010010111111000110001010100101110101111101101001010
0110000000010111000110111010101010010011110100111101010011011010001011111011010011110010001011011000
1110110010010011000101101110111110100001110110001101101000100100100001100110011010101001001111110001
1101101100011101010010011011110101110110001111101110010110010010000101101000111101010110000011010111
1011101100110101000111101110011111111100111100100010111100010110011001001100101010111010100010010100
1101000000001111011010011010110110011010001000011110010100111110000110111001011101111100010000001100
0110110101100011010100011011010101111111001010000111011111111100100100110111110111100110101000010101
1111101101100011001111001000100000001101110111010011001100001000011101000110111011101100101001000101
1000011001100001010101110010010111010010110001001101000011111010010111100110101001010000101111110011
1010111000010110110101101010111110011010001110010111111011110011101001011011010010111111100100111001
0110110000010011010111100110000111110111101111010000101111010111010101011101000110111000001101011011
1101101110100011100110110000011011101100100001111001001010000100101010000101110111111101111010011100
0101110010111011111101111111011101100010101001110010110111001111010011001000110110101101000000111100
0010110010100011111001011001101111101000000110010011111100110101110111111010001000111000111011011100
0101010101100100101011010010100010110100000001100100000101011110110110100111101101111110110001100100
1001101000111111000001000001111100000110111011111111001110000100110110100011101010110110010100001010
0000001000001110010011001100011001001010000110000110110101010110110001000101111100001110010100010011
0000111101000110110011110001110010010111110011111111101101101010100110011100100000110001011100010100
1001111000001010111001001100111010100010110010001001010001001110111001111110001010101010001001101011
1000101010111111011111101011010100111011001111111111001101111101101111000100100110100011100100001101
1001000001111100101100001011101110010010110110111011110100000100100000110001000110001010101111011000
1010000000011111100110001000011000110100111100110101011100101001111011111010000011110001011000010001
0101010011000101000111101001001101100101000111000001100100110011011010100100110110001000110000001110
0111101110010111011110010101000110001101100101101101011011110100011111011011010010100000110110111111
0111010110000111110001100111000111001111110001000101110110111110111100010111001011101100000011010100
0101101111110001110010100010111101000011000111001011111011000101111110101110000111101000011001101100
0111000001101110011101011100010100010011100111110010111000101111111111100011000110110111100110010001
1111001111011011101110111101110000101001110001011010000101110111100010010100001010011100101101001001
1111010001000011110110010010111100001001110111110110000111110010010100100000111110111100001110011010
0110101000001101100001011100010001111110111101110111100001100011111111001101000100101101110011100111
1010001110000110000110110111111110011110010101111111111111011100011000010110101010110101100111011101
1111101110011000011111010100101001000110011011001010010011001010000010000100100010001100111111110100
0101011010001101100101100011010011111001000111001110011011000001110100010010001000001101100100101101
1101011110111010010110010001000111010001110100010100111111100101001010111111000000000000111100000011
1111010100011100000111011001111001111100001111010101111011010111011111000010101100100100110010010100
1000010100110110110100110110000110010100100111010001010111000001100011011011011000111011001011000011
0101001001011111101100010111110101100111010010111001001101011001110001001001111000100001010110001101
0000111000111000001010000111011001010000000010101100000111100001001100001001110100110001101000011111
1101001111100010101010001000010110111011111110010011110110100001111100010010101001010000001111010110
1010010110110101110100001100111101100110111011110111111001100111001101101100111001101010101110000110
0000101010110010110110111011010100011100010110110000010111010110010011010101111000000111010001110110
1111011001101001101010001011110011101011111001011011110110100110010010011000100000001101010110100110
1110000111000010101111100011000110111001000010000011000010000010010110111011100110111100101001011000
0000101100100010101101001011000010000010110001110001010101010101010110101010111101111010010110011100
0000111001100100101000111001111111001011001110001001110111000011001110010110001100011101101101001111
1101111100111110110100010001101111100110001110110111000110110100110101100001111100000101110001001001
1100010101001010101011101001100011010111111011101010010000101010111100011011001000111011110000011000
1100111100111010110001010110100110010011011001110100010010101000110101001010000010011101101011001001
1111010011110011100011001000111000010111011001101010000100100011101110101011001010111000010000000110
1100011000111100001101000011001110101110011101110101000111111111100110001100101000001001110101101000
1101011110011100011111110101101100000011001101010010011110111101101001110110001101100000011100001110
1111000011010000011001000001111111000111111000110010011101000100000100010100110101110010100111101111
0011001101011111101001110100100101110001001110101001001100011001010101010111011100100010010000110001
1001101101110101011111100000011110100001010111010111100110001110001100001101011100011011011110011100
0010010010010111011001000001011010101000011111000000111100001001011111010010001000111001111011100000
0011011101110101010100100100111101111000110001110111110010001010011011010000000011011101011111101110
1011110001100010010011001011101000011110000001001011010010100101001010111001111111110001111010101010
0100100111000001000010001110001111010111110011011010001100110110110101001111001000010000001000001001
0101111111001011101000010001101101110110011011011011010001110001110100011000010110110110101111000010
1010110110111110010101011110110000001011011110000110110111110011100001110101001101111000111000101100
1100100110011110100100110000011010101001100010011110100010110100001100111011011000110010010100011000
0011110011101100011101010111000110100011001001010110101010111011110011011000001001010110011110011110
1100111000110011000000100100001111000001100010101011111101010110000001100001010110111001011100001010
0100111000111001011001110101100011100010100010111110011111101000111010110011110110011010111000000101
0111110010001011011011101101101000110010100011101011110011000000010110001110100001001010111011010000
1010111001001101111000000000000111000111101111110010011110011101010111001110011001110000111000101100
0010101010101100010000111001010011100100100110000111101001011101100100000101110110110100001000010000
0101010001001100000100010100101100010010010111111010010110000100010001001111111110110101100101001010
1101001001001100011101001010011011001001000101111111011110000010101101010100101010011001011000001101
0110000110010010001100011011101000000111111011111010101110100000110010011111000001011100011011101100
0111001111011010100111110100110111101001100100000010100101001010110000111000110100011010101110011011
0101110010001100000101100001000000010110010101111000111111111010111100111000110101101110001110111001
0101001111000000010101100001111010000001101101000000011001010000111111111011101011100111010110010111
